images.google	prev=	q=
google	p=
google	q=
yahoo	p=
msn	q=
dogpile	q=
dogpile	kw=
altavista	q=
alexa	q=
alltheweb	q=
alltheweb	query=
dmoz	search=
mamma	query=
lycos	query=
search\.netscape\.com	query=
netscape	search=
aol	query=
hotbot	query=
terra	query=
voila	kw=
sympatico	query=
excite	search=
go	qt=
ask	q=
ask	ask=
atomz	sp-q=
euroseek	query=
findarticles	key=
go2net	general=
infospace	q=
infospace	kw=
kvasir	q=
looksmart	key=
metacrawler	general=
nbci	keyword=
iune	keywords=
iune	q=
northernlight	qr=	
overture	keywords=
overture	Keywords=
spray	string=
teoma	q=
virgilio	qs=
webcrawler	searchText=
wisenut	query=
ixquick	query=
earthlink	q=
vivisimo	query=
naver	query=
iwon	searchfor=
search\.com	q=
websearch\.cs\.com	query=
eniro.se	;q=
eniro.se	\?q=
avantfind\.com	Keywords=
myway	searchfor=
mywbsearch	keywords=
szukaj\.wp	szukaj=
wanadoo	q=
netster	Keywords=
rediff	MT=
startsiden\.no	q=
tiscali	query=
mywebsearch	searchfor=
prsearch\.net	Query=
dogpile	search\/web\/
globalspec	query=
pipeline\-search	query=